IIIIIIIIIIIIIII
I@@@@@@@@@@@@@I
I@@@@O@@@@@@@@I
I@P@@@@@@W@@@@I
I@@@@@@@@@@@@@I
IIIIIIIIIIIIIII
