IIIIIIIIIII
IP_wwwww__I
I_W_W_W_W_I
Iw_wwww_wwI
IwW_W_W_W_I
Iw_w_ww__wI
IwW_W_W_WwI
Iw_w__ww_wI
IwW_W_WwWwI
Iw_www_w_wI
I_W_W_W_W_I
I__wwwww__I
IIIIIIIIIII